10
W.-.-.-.-.-.-.-.-.G
-.P.-.-.-.-.-.-.-.-
-.-.P.-.-.-.-.-.-.-
-.-.-.P.-.-.-.-.-.-
-.-.-.-.P.-.-.-.-.-
-.-.-.-.-.P.-.-.-.-
-.-.-.-.-.-.P.-.-.-
-.-.-.-.-.-.-.P.-.-
-.-.-.-.-.-.-.-.P.-
A.-.-.-.-.-.-.-.-.P